; struct laze: # - wall, ' ' - koridor || widh height koordinaty vector
15 15 1.5 1.5 0

###############
#         #   #
# # ##### #####
# #       # # #
# #  ###  # # #
# #   #   # # #
#  ## #     # #
#   # #  #  # #
#   # # ##    #
#   # #  ######
# #   ## #    #
# #####  #    #
#     #  ## ###
#     #   #   #
#####@#########